fiets	bicicleta
kat	gato
koffie	café
vier	cuatro
vriend	amigo
huis	casa
geld	dinero
moeder	madre
zeven	siete
twee	dos
appel	manzana
augustus	agosto
boek	libro
kaas	queso
kip	pollo
stad	ciudad
dag	día
acht	ocho
vader	padre
vijf	cinco
bloem	flor
juli	julio
juni	junio
vlees	carne
melk	leche
oktober	octubre
zus	hermana
zes	seis
winkel	tienda
zon	sol
tien	diez
drie	tres
