lucht	luft
fiets	cykel
zwart	svart
bloed	blod
blauw	blå
kat	katt
koffie	kaffe
ei	ägg
vier	fyra
vriend	vän
geslacht	kön
grijs	grå
huis	hus
keuken	kök
geld	pengar
moeder	mor
naam	namn
nacht	natt
normaal	vanligt
een	ett
manier	sätt
zeven	sju
straat	gata
temperatuur	temperatur
twee	två
vrouw	fru
woord	ord
jaar	år
geel	gul
