zwart	czarny
blauw	niebieski
kat	kot
koffie	kawa
grijs	szary
geld	pieniądze
moeder	matka
naam	nazwa
nacht	noc
een	jeden
manier	droga
straat	ulica
twee	dwa
jaar	rok
acteur	aktor
auteur	autor
stad	miasto
dag	dzień
oog	oko
bloem	kwiat
paard	koń
liefde	miłość
broek	spodnie
rood	czerwony
winkel	sklep
zoon	syn
bedankt	dzięki
drie	trzy
dorp	wieś
