fiets	Fahrrad
kat	Katze
koffie	Kaffee
vriend	Freund
huis	Haus
geld	Geld
moeder	Mutter
straat	Straße
twee	zwei
appel	Apfel
boek	Buch
kaas	Käse
stad	Stadt
vader	Vater
vijf	fünf
bloem	Blume
tuin	Garten
eiland	Insel
juli	Juli
juni	Juni
liefde	Liebe
melk	Milch
broek	Hose
winkel	Geschäft
zomer	Sommer
zon	Sonne
drie	drei
