vélo	cykel
noir	svart
bleu	blå
voiture	bil
chat	katt
café	kaffe
ordinateur	dator
chien	hund
bas	ner
poisson	fisk
forêt	skog
quatre	fyra
ami	vän
gris	grå
maison	hus
cuisine	kök
membre	medlem
argent	pengar
mère	mor
musique	musik
nom	namn
un	ett
riz	ris
route	sätt
école	skola
sept	sju
rue	gata
température	temperatur
arbre	träd
deux	två
haut	upp
eau	vatten
nous	vi
blanc	vit
épouse	fru
mot	ord
jaune	gul
