Fahrrad	bisiklet
Katze	kedi
Kaffee	kahve
Computer	bilgisayar
Hund	köpek
vier	dört
Freund	arkadaş
Geld	para
Musik	müzik
Schule	okul
Straße	sokak
zwei	iki
Wasser	su
wir	biz
Buch	kitap
Stadt	şehir
fünf	beş
Blume	çiçek
Juli	Temmuz
Juni	Haziran
Liebe	aşk
Hose	pantolon
Sommer	yaz
drei	üç
Tür	kapı
Tee	çay
Vogel	kuş
Dezember	Aralık
Winter	kış
