Fahrrad	cykel
Auto	bil
Katze	katt
Kaffee	kaffe
Computer	dator
Hund	hund
Fisch	fisk
Wald	skog
vier	fyra
Freund	vän
Haus	hus
Geld	pengar
Mutter	mor
Musik	musik
Schule	skola
Straße	gata
Baum	träd
zwei	två
Wasser	vatten
wir	vi
