Fahrrad	bicicleta
Computer	computador
Fisch	peixe
Wald	floresta
Haus	casa
Geld	dinheiro
Mutter	mãe
Musik	música
Straße	rua
Wasser	água
wir	nós
Buch	livro
Käse	queijo
Stadt	cidade
acht	oito
Vater	pai
Garten	jardim
Insel	ilha
Juli	julho
Juni	junho
Hose	calça
Geschäft	loja
Sommer	verão
Brot	pão
Bruder	irmão
Land	país
Tür	porta
Hut	chapéu
Ehemann	marido
Fluss	rio
sie	ela
Tee	chá
Fenster	janela
Dezember	dezembro
Winter	inverno
