Katze	gatto
Kaffee	caffè
vier	quattro
Haus	casa
Geld	soldi
Mutter	madre
Musik	musica
Straße	strada
Baum	albero
Wasser	acqua
Buch	libro
Käse	formaggio
Stadt	città
Vater	padre
fünf	cinque
Blume	fiore
Garten	giardino
Insel	isola
Juli	luglio
Juni	giugno
Liebe	amore
Hose	pantaloni
Geschäft	negozio
drei	tre
Bruder	fratello
Land	paese
Tür	porta
Hut	cappello
Ehemann	marito
Fluss	fiume
sie	lei
Tee	tè
Fenster	finestra
Telefon	telefono
Dezember	dicembre
Schiff	barca
