sangue	blod
blu	blå
gatto	katt
caffè	kaffe
giù	ner
uovo	ägg
quattro	fyra
pavimento	kön
grigio	grå
capelli	hår
casa	hus
cucina	kök
membro	medlem
soldi	pengar
madre	mor
bocca	mun
musica	musik
nome	namn
notte	natt
riso	ris
modo	sätt
strada	gata
temperatura	temperatur
albero	träd
acqua	vatten
bianco	vit
moglie	fru
donna	kvinna
anno	år
