gatto	gato
caffè	café
quattro	cuatro
soldi	dinero
musica	música
acqua	agua
formaggio	queso
città	ciudad
giorno	día
cinque	cinco
fiore	flor
luglio	julio
giugno	junio
ottobre	octubre
sorella	hermana
negozio	tienda
dieci	diez
tre	tres
fratello	hermano
porta	puerta
fiume	río
lei	ella
tè	té
squadra	equipo
finestra	ventana
telefono	teléfono
dicembre	diciembre
novembre	noviembre
settembre	septiembre
vacanza	vacaciones
barca	barco
