czarny	svart
niebieski	blå
kot	katt
kawa	kaffe
szary	grå
włosy	hår
człon	medlem
pieniądze	pengar
matka	mor
usta	mun
nazwa	namn
noc	natt
jeden	ett
droga	sätt
ulica	gata
dwa	två
woda	vatten
biały	vit
kobieta	kvinna
rok	år
