czarny	siyah
niebieski	mavi
kot	kedi
kawa	kahve
szary	gri
włosy	saç
pieniądze	para
nazwa	isim
noc	gece
jeden	bir
droga	yol
ulica	sokak
dwa	iki
woda	su
biały	beyaz
kobieta	kadın
rok	yıl
autor	yazar
miasto	şehir
dzień	gün
oko	göz
kwiat	çiçek
miłość	aşk
spodnie	pantolon
czerwony	kırmızı
trzy	üç
wieś	köy
drzwi	kapı
zespół	takım
głos	ses
sto	yüz
osoba	kişi
tabela	masa
gitara	gitar
