niebieski	azul
szary	cinza
włosy	cabelo
pieniądze	dinheiro
matka	mãe
usta	boca
noc	noite
droga	estrada
ulica	rua
woda	água
kobieta	mulher
rok	ano
aktor	ator
miasto	cidade
spodnie	calça
sklep	loja
syn	filho
dzięki	obrigado
kamera	câmera
kraj	país
drzwi	porta
samochód	máquina
człowiek	homem
północ	norte
ona	ela
zespół	equipe
głos	voz
okno	janela
