bicicleta	cykel
azul	blå
computador	dator
ovo	ägg
peixe	fisk
floresta	skog
fruta	frukt
cinza	grå
cabelo	hår
casa	hus
cozinha	kök
dinheiro	pengar
mãe	mor
boca	mun
música	musik
noite	natt
oceano	hav
arroz	ris
estrada	sätt
rua	gata
água	vatten
nós	vi
esposa	fru
mulher	kvinna
palavra	ord
ano	år
