computador	ordenador
peixe	pescado
floresta	bosque
dinheiro	dinero
mãe	madre
água	agua
nós	nosotros
livro	libro
queijo	queso
frango	pollo
cidade	ciudad
oito	ocho
pai	padre
julho	julio
junho	junio
outubro	octubre
irmã	hermana
loja	tienda
pão	pan
irmão	hermano
porta	puerta
rio	río
ela	ella
chá	té
equipe	equipo
janela	ventana
dezembro	diciembre
novembro	noviembre
setembro	septiembre
férias	vacaciones
