автомобиль	coche
кот	gato
кофе	café
компьютер	ordenador
собака	perro
рыба	pescado
лес	bosque
четыре	cuatro
дом	casa
деньги	dinero
мать	madre
музыка	música
школа	escuela
два	dos
вода	agua
книга	libro
сыр	queso
город	ciudad
день	día
отец	padre
пять	cinco
цветок	flor
мясо	carne
сестра	hermana
шесть	seis
магазин	tienda
солнце	sol
десять	diez
три	tres
хлеб	pan
брат	hermano
дверь	puerta
река	río
она	ella
чай	té
команда	equipo
окно	ventana
сто	cien
телефон	teléfono
