воздух	luft
черный	svart
кровь	blod
синий	blå
автомобиль	bil
кот	katt
кофе	kaffe
компьютер	dator
собака	hund
вниз	ner
яйцо	ägg
рыба	fisk
лес	skog
четыре	fyra
пол	kön
серый	grå
волосы	hår
дом	hus
кухня	kök
член	medlem
деньги	pengar
мать	mor
рот	mun
музыка	musik
имя	namn
ночь	natt
один	ett
рис	ris
дорога	sätt
школа	skola
улица	gata
температура	temperatur
дерево	träd
два	två
вверх	upp
вода	vatten
белый	vit
жена	fru
женщина	kvinna
год	år
