bicicleta	bisiklet
gato	kedi
café	kahve
ordenador	bilgisayar
perro	köpek
cuatro	dört
amigo	arkadaş
dinero	para
música	müzik
escuela	okul
dos	iki
agua	su
nosotros	biz
agosto	Ağustos
libro	kitap
ciudad	şehir
día	gün
cinco	beş
flor	çiçek
julio	Temmuz
junio	Haziran
octubre	Ekim
seis	altı
tres	üç
puerta	kapı
té	çay
equipo	takım
cien	yüz
diciembre	Aralık
noviembre	Kasım
septiembre	Eylül
