luft	hava
cykel	bisiklet
svart	siyah
blå	mavi
katt	kedi
kaffe	kahve
dator	bilgisayar
hund	köpek
fyra	dört
vän	arkadaş
grå	gri
hår	saç
kök	mutfak
pengar	para
musik	müzik
namn	isim
natt	gece
ett	bir
sätt	yol
skola	okul
gata	sokak
två	iki
vatten	su
vi	biz
vit	beyaz
kvinna	kadın
ord	kelime
år	yıl
gul	sarı
